########################
#@..#...g......B.....g.#
#.###.g##..####...#..###
#...g...g..#BB#...#.B..#
#g....g.#.g.....g.###..#
###################.g..#
#.D.#.S..#g....B..#..###
#...###..#..g.##..#..g.#
#....B....B...#...S....#
########################