###############
#@............#
#.............#
#........D....#
#.............#
###############